5
5
#####
#...#
#.@.#
#...#
#####