15
1h
###############
#.....#.......#
#####.####..###
#.....#......##
#..####....#..#
#..........####
#......@......#
#........####.#
#......#.#....#
#..############
#......#...#..#
#..#####.#.##.#
#......#.#.#..#
#........#....#
###############